#########################################
# #       #   #       #   #       #     #
# # ##### # ### ### # # # ### ### # ### #
#   # #   #   #   # #   # #   # # #   # #
##### # ### # ### # ##### # ### # # ### #
#   #   #   #     #   # # # #     # #   #
# # # ##### ######### # # # ### ##### # #
# # #     #         # # # #   #   #   # #
# ####### # ######### # # ### ### # ### #
# #     # # #       # # #     # # # #   #
# # # ### # # ##### # # ####### # # # ###
#   #     # #   # #   #     #   # # #   #
# ############# # ##### # ### # # # ### #
#             # #     # #     # # #   # #
############# # # ### # ####### # ### # #
#     #       # #   #   #     #   #   # #
# # ### ####### ### ##### ### ##### #####
# #   # #       # #     #   #   #       #
# ### # ### ##### ##### ### ### # ##### #
# #   #   # #       # #   # # #   #     #
# # ##### # # ##### # ### # # ##### ### #
# #     #   #   #   # #   # #     # # # #
####### ####### # ### # ### ### # # # # #
#   #     #     #   # #   #     # # # # #
# # # ### # ####### # ### ##### ### # # #
# #   # # # #     #   # #     # #   # # #
# ##### # # ##### ### # ##### # # ### # #
#   # #     #   #       #   # # # #     #
### # # ##### # ####### ### # ### #######
#   #     #   #     #       #   #   #   #
# ######### ####### ########### # # # # #
#   #     #   #   #   #       # # #   # #
# # # ### ### # ##### # ### ### ####### #
# #   # #   # #     #   # #     #     # #
# ##### ### # # # # ##### ####### ### # #
#   #   #   # # # #           #   #     #
### # ### # # # # ########### # # ##### #
#   # #   # # # # #     #   # # #   # # #
# ### # ##### ### # ##### # # ##### # # #
#     #           #       #         #   #
#########################################