############
#  #       #
##  #      #
# #  #     #
#  #  #    #
##  #  #   #
# #  #  ## #
#  #  # # ##
#     # #  #
#     # #  #
# #   #    #
############