############
#          #
##         #
#  #       #
#   #      #
##   # #   #
# #    # # #
#  # #  # ##
#    # #   #
#     #    #
# #        #
############